12 12
XXXXXXXXXXXX
XG.K.GX...TX
X..XX.XX...X
X..X.......X
X..X.XXX.X.X
X........X.X
X.XXX.XX.X.X
X.....X....X
XX.X.......X
XS.X.XX....X
X.....X..G.X
XXXXXXXXXXXX