12 12
XXXXXXXXXXXX
X.......X..X
X.XXX.X.X..X
X.X...X....X
X...XXX..GXX
X.S.XT..XGGX
X...XXX..GXX
X.....X....X
X.XXX.X.XX.X
X.X........X
X...XXX....X
XXXXXXXXXXXX