5 5
XXXXX
X.GTX
XKX.X
X.S.X
XXXXX