12 12
XXXXXXXXXXXX
XGG...X...TX
X.....XX...X
X..........X
X..........X
X..........X
X..........X
X..........X
XXXX.....K.X
XS.X.......X
X........G.X
XXXXXXXXXXXX